####################################################################################################################################################
#@.........................................#.......................................................................................................#
#..........................................#.......................................................................................................#
#..........................................#.......................................................................................................#
#..........................................#.......................................................................................................#
#..........................................#.......................................................................................................#
#######.####################################.......................................................................................................#
#..................................................................................................................................................#
#..................................................................................................................................................#
#..................................................................................................................................................#
#..................................................................................................................................................#
#..................................................................................................................................................#
#..................................................................................................................................................#
#..................................................................................................................................................#
#.........................................................g........................................................................................#
#..................................................................................................................................................#
#..................................................................................................................................................#
#..................................................................................................................................................#
#..................................................................................................................................................#
#..................................................................................................................................................#
#.............................................g....................................................................................................#
#..................................................................................................................................................#
#..................................................................................................................................................#
#..................................................................................................................................................#
#..................................................................................................................................................#
#..................................................................................................................................................#
#..................................................................................................................................................#
#..................................................................................................................................................#
#..................................................................................................................................................#
#..................................................................................................................................................#
#.............................................................................g....................................................................#
#..................................................................................................................................................#
#..................................................................................................................................................#
#..................................................................................................................................................#
#..................................................................................................................................................#
#..................................................................................................................................................#
#..................................................................................................................................................#
#..................................................................................................................................................#
#..................................................................................................................................................#
#..................................................................................................................................................#
#..................................................................................................................................................#
#..................................................................................................................................................#
#..................................................................................................................................................#
#..................................................................................................................................................#
#..................................................................................................................................................#
#..................................................................................................................................................#
#..................................................................................................................................................#
####################################################################################################################################################