####################################################################################################################################################
#@...................#.....................#.......................................................................................................#
#....................#.....................#.......................................................................................................#
#....................##########.############.......................................................................................................#
#......................................s...#.......................................................................................................#
#....................#.....................#.......................................................................................................#
#######.###########################.########.......................................................................................................#
#..................................................................................................................................................#
#..................................................................................................................................................#
#..................................................................................................................................................#
#..................................................................................................................................................#
#..................................................................................................................................................#
#..................................................................................................................................................#
#..................................................................................................................................................#
#.........................................................g........................................................................................#
#..................................................................................................................................................#
#..................................................................................................................................................#
#..................................................................................................................................................#
#..................................................................................................................................................#
#..................................................................................................................................................#
#.............................................g....................................................................................................#
#..................................................................................................................................................#
#..................................................................................................................................................#
#..................................................................................................................................................#
#..................................................................................................................................................#
#..................................................................................................................................................#
#..................................................................................................................................................#
#..................................................................................................................................................#
#..................................................................................................................................................#
#..................................................................................................................................................#
#.............................................................................g....................................................................#
#..................................................................................................................................................#
#..................................................................................................................................................#
#..................................................................................................................................................#
#..................................................................................................................................................#
#..................................................................................................................................................#
#..................................................................................................................................................#
#..................................................................................................................................................#
#..................................................................................................................................................#
#..................................................................................................................................................#
#..................................................................................................................................................#
#..................................................................................................................................................#
#..................................................................................................................................................#
#..................................................................................................................................................#
#..................................................................................................................................................#
#..................................................................................................................................................#
#..................................................................................................................................................#
####################################################################################################################################################